hiragana-a	<div id="japanese-heroic-character"><span class="hiragana">ã‚</span></div>	<div id="japanese-romaji-answer">a</div><div>ã‚ãã¾<br>ã‚ã•ã”ã¯ã‚“</div>	hiragana
hiragana-i	<div id="japanese-heroic-character"><span class="hiragana">ã„</span></div>	<div id="japanese-romaji-answer">i</div><div>ãŠã¯ã‚ˆã†ã”ã–ã„ã¾ã™<br>ã„ã<br>ã„ã¡ 1âƒ£<br>ãˆã„ã”<br>ã„ã¬ ğŸ•</div>	hiragana
hiragana-u	<div id="japanese-heroic-character"><span class="hiragana">ã†</span></div>	<div id="japanese-romaji-answer">u</div><div>ã¡ã‚…ã†ã”ã ğŸ‡¨ğŸ‡³<br>ã•ã‚ˆã†ãªã‚‰<br>ãŠã¯ã‚ˆã†ã”ã–ã„ã¾ã™<br>ãŠã¯ã‚ˆã†<br>ã‹ã†<br>ã¹ã‚“ãã‚ˆã†ã™ã‚‹<br>ã˜ã‚…ã† ğŸ”Ÿ<br>ãã‚…ã† 9âƒ£</div>	hiragana
hiragana-e	<div id="japanese-heroic-character"><span class="hiragana">ãˆ</span></div>	<div id="japanese-romaji-answer">e</div><div>ã‹ãˆã‚‹<br>ãˆã„ã”<br>ãˆã³ ğŸ¤</div>	hiragana
hiragana-o	<div id="japanese-heroic-character"><span class="hiragana">ãŠ</span></div>	<div id="japanese-romaji-answer">o</div><div>ãŠã¯ã‚ˆã†ã”ã–ã„ã¾ã™<br>ãŠã¯ã‚ˆã†<br>ãŠãã‚‹<br>ãŠã•ã‘ ğŸ¶</div>	hiragana
hiragana-ka	<div id="japanese-heroic-character"><span class="hiragana">ã‹</span></div>	<div id="japanese-romaji-answer">ka</div><div>ã‹ã‚“ã“ã ğŸ‡°ğŸ‡·<br>ã‹<br>ã‹ã†<br>ã‹ãˆã‚‹<br>ã‹ã‚‰ã¦</div>	hiragana
hiragana-ga	<div id="japanese-heroic-character"><span class="hiragana">ãŒ</span></div>	<div id="japanese-romaji-answer">ga</div><div></div>	hiragana
hiragana-ki	<div id="japanese-heroic-character"><span class="hiragana">ã</span></div>	<div id="japanese-romaji-answer">ki</div><div>ãã<br>ãŠãã‚‹<br>ã¹ã‚“ãã‚ˆã†ã™ã‚‹<br>ãã‚…ã† 9âƒ£<br>ãã¤ã­ ğŸ¦Š<br>ã¦ã‚Šã‚„ã</div>	hiragana
hiragana-gi	<div id="japanese-heroic-character"><span class="hiragana">ã</span></div>	<div id="japanese-romaji-answer">gi</div><div>ãã‚“</div>	hiragana
hiragana-ku	<div id="japanese-heroic-character"><span class="hiragana">ã</span></div>	<div id="japanese-romaji-answer">ku</div><div>ã¡ã‚…ã†ã”ã ğŸ‡¨ğŸ‡³<br>ã‹ã‚“ã“ã ğŸ‡°ğŸ‡·<br>ãã<br>ã„ã<br>ãã‚‹<br>ã²ã‚ƒã ğŸ’¯<br>ã‚ã 6âƒ£<br>ã‚ãã¾</div>	hiragana
hiragana-gu	<div id="japanese-heroic-character"><span class="hiragana">ã</span></div>	<div id="japanese-romaji-answer">gu</div><div></div>	hiragana
hiragana-ke	<div id="japanese-heroic-character"><span class="hiragana">ã‘</span></div>	<div id="japanese-romaji-answer">ke</div><div>ã‘ã‚€ã—<br>ãŠã•ã‘ ğŸ¶</div>	hiragana
hiragana-ge	<div id="japanese-heroic-character"><span class="hiragana">ã’</span></div>	<div id="japanese-romaji-answer">ge</div><div></div>	hiragana
hiragana-ko	<div id="japanese-heroic-character"><span class="hiragana">ã“</span></div>	<div id="japanese-romaji-answer">ko</div><div>ã‹ã‚“ã“ã ğŸ‡°ğŸ‡·<br>ã“ã‚“ã°ã‚“ã¯<br>ã“ã‚“ã«ã¡ã¯<br>ãŸã“ ğŸ™<br>ã­ã“ ğŸˆ</div>	hiragana
hiragana-go	<div id="japanese-heroic-character"><span class="hiragana">ã”</span></div>	<div id="japanese-romaji-answer">go</div><div>ã¡ã‚…ã†ã”ã ğŸ‡¨ğŸ‡³<br>ãŠã¯ã‚ˆã†ã”ã–ã„ã¾ã™<br>ã” 5âƒ£<br>ã«ã»ã‚“ã”<br>ãˆã„ã”<br>ã²ã‚‹ã”ã¯ã‚“<br>ã°ã‚“ã”ã¯ã‚“<br>ã‚ã•ã”ã¯ã‚“<br>ã”ã¯ã‚“ ğŸš</div>	hiragana
hiragana-sa	<div id="japanese-heroic-character"><span class="hiragana">ã•</span></div>	<div id="japanese-romaji-answer">sa</div><div>ã•ã‚ˆã†ãªã‚‰<br>ã•ã‚“ 3âƒ£<br>ã•ã‚‹ ğŸ’<br>ãŠã•ã‘ ğŸ¶<br>ã‚ã•ã”ã¯ã‚“</div>	hiragana
hiragana-za	<div id="japanese-heroic-character"><span class="hiragana">ã–</span></div>	<div id="japanese-romaji-answer">za</div><div>ãŠã¯ã‚ˆã†ã”ã–ã„ã¾ã™</div>	hiragana
hiragana-shi	<div id="japanese-heroic-character"><span class="hiragana">ã—</span></div>	<div id="japanese-romaji-answer">shi</div><div>ã‚€ã— ğŸ›<br>ã‘ã‚€ã—<br>ã™ã— ğŸ£<br>ã—ã‚</div>	hiragana
hiragana-zi	<div id="japanese-heroic-character"><span class="hiragana">ã˜</span></div>	<div id="japanese-romaji-answer">ji</div><div>ã˜ã‚…ã† ğŸ”Ÿ</div>	hiragana
hiragana-su	<div id="japanese-heroic-character"><span class="hiragana">ã™</span></div>	<div id="japanese-romaji-answer">su</div><div>ãŠã¯ã‚ˆã†ã”ã–ã„ã¾ã™<br>ã¾ã™<br>ã¯ãªã™<br>ã¹ã‚“ãã‚ˆã†ã™ã‚‹<br>ã™ã‚‹<br>ã™ã— ğŸ£</div>	hiragana
hiragana-zu	<div id="japanese-heroic-character"><span class="hiragana">ãš</span></div>	<div id="japanese-romaji-answer">zu</div><div>ã¿ãš ğŸ’§</div>	hiragana
hiragana-se	<div id="japanese-heroic-character"><span class="hiragana">ã›</span></div>	<div id="japanese-romaji-answer">se</div><div>ã¾ã›ã‚“</div>	hiragana
hiragana-ze	<div id="japanese-heroic-character"><span class="hiragana">ãœ</span></div>	<div id="japanese-romaji-answer">ze</div><div></div>	hiragana
hiragana-so	<div id="japanese-heroic-character"><span class="hiragana">ã</span></div>	<div id="japanese-romaji-answer">so</div><div></div>	hiragana
hiragana-zo	<div id="japanese-heroic-character"><span class="hiragana">ã</span></div>	<div id="japanese-romaji-answer">zo</div><div></div>	hiragana
hiragana-ta	<div id="japanese-heroic-character"><span class="hiragana">ãŸ</span></div>	<div id="japanese-romaji-answer">ta</div><div>ãŸã¹ã‚‹<br>ãŸã“ ğŸ™</div>	hiragana
hiragana-da	<div id="japanese-heroic-character"><span class="hiragana">ã </span></div>	<div id="japanese-romaji-answer">da</div><div></div>	hiragana
hiragana-chi	<div id="japanese-heroic-character"><span class="hiragana">ã¡</span></div>	<div id="japanese-romaji-answer">chi</div><div>ã¡ã‚…ã†ã”ã ğŸ‡¨ğŸ‡³<br>ã“ã‚“ã«ã¡ã¯<br>ã¯ã¡ 8âƒ£<br>ã„ã¡ 1âƒ£</div>	hiragana
hiragana-di	<div id="japanese-heroic-character"><span class="hiragana">ã¢</span></div>	<div id="japanese-romaji-answer">ji</div><div></div>	hiragana
hiragana-tsu	<div id="japanese-heroic-character"><span class="hiragana">ã¤</span></div>	<div id="japanese-romaji-answer">tsu</div><div>ãã¤ã­ ğŸ¦Š</div>	hiragana
hiragana-du	<div id="japanese-heroic-character"><span class="hiragana">ã¥</span></div>	<div id="japanese-romaji-answer">zu</div><div></div>	hiragana
hiragana-te	<div id="japanese-heroic-character"><span class="hiragana">ã¦</span></div>	<div id="japanese-romaji-answer">te</div><div>ã‹ã‚‰ã¦<br>ã¦ã‚Šã‚„ã</div>	hiragana
hiragana-de	<div id="japanese-heroic-character"><span class="hiragana">ã§</span></div>	<div id="japanese-romaji-answer">de</div><div>ã§</div>	hiragana
hiragana-to	<div id="japanese-heroic-character"><span class="hiragana">ã¨</span></div>	<div id="japanese-romaji-answer">to</div><div>ã¨</div>	hiragana
hiragana-do	<div id="japanese-heroic-character"><span class="hiragana">ã©</span></div>	<div id="japanese-romaji-answer">do</div><div></div>	hiragana
hiragana-na	<div id="japanese-heroic-character"><span class="hiragana">ãª</span></div>	<div id="japanese-romaji-answer">na</div><div>ã•ã‚ˆã†ãªã‚‰<br>ã¯ãªã™<br>ãªãª 7âƒ£</div>	hiragana
hiragana-ni	<div id="japanese-heroic-character"><span class="hiragana">ã«</span></div>	<div id="japanese-romaji-answer">ni</div><div>ã«ã»ã‚“ ğŸ‡¯ğŸ‡µ<br>ã“ã‚“ã«ã¡ã¯<br>ã« 2âƒ£<br>ã«ã»ã‚“ã”</div>	hiragana
hiragana-nu	<div id="japanese-heroic-character"><span class="hiragana">ã¬</span></div>	<div id="japanese-romaji-answer">nu</div><div>ã„ã¬ ğŸ•</div>	hiragana
hiragana-ne	<div id="japanese-heroic-character"><span class="hiragana">ã­</span></div>	<div id="japanese-romaji-answer">ne</div><div>ã­ã‚‹<br>ãã¤ã­ ğŸ¦Š<br>ã­ã“ ğŸˆ</div>	hiragana
hiragana-no	<div id="japanese-heroic-character"><span class="hiragana">ã®</span></div>	<div id="japanese-romaji-answer">no</div><div>ã®<br>ã®ã‚€</div>	hiragana
hiragana-ha	<div id="japanese-heroic-character"><span class="hiragana">ã¯</span></div>	<div id="japanese-romaji-answer">ha</div><div>ã“ã‚“ã°ã‚“ã¯<br>ã“ã‚“ã«ã¡ã¯<br>ãŠã¯ã‚ˆã†ã”ã–ã„ã¾ã™<br>ãŠã¯ã‚ˆã†<br>ã¯<br>ã¯ãªã™<br>ã¯ã¡ 8âƒ£<br>ã²ã‚‹ã”ã¯ã‚“<br>ã°ã‚“ã”ã¯ã‚“<br>ã‚ã•ã”ã¯ã‚“<br>ã”ã¯ã‚“ ğŸš</div>	hiragana
hiragana-ba	<div id="japanese-heroic-character"><span class="hiragana">ã°</span></div>	<div id="japanese-romaji-answer">ba</div><div>ã“ã‚“ã°ã‚“ã¯<br>ã°ã‚“ã”ã¯ã‚“</div>	hiragana
hiragana-pa	<div id="japanese-heroic-character"><span class="hiragana">ã±</span></div>	<div id="japanese-romaji-answer">pa</div><div></div>	hiragana
hiragana-hi	<div id="japanese-heroic-character"><span class="hiragana">ã²</span></div>	<div id="japanese-romaji-answer">hi</div><div>ã²ã‚ƒã ğŸ’¯<br>ã²ã‚‹ã”ã¯ã‚“</div>	hiragana
hiragana-bi	<div id="japanese-heroic-character"><span class="hiragana">ã³</span></div>	<div id="japanese-romaji-answer">bi</div><div>ãˆã³ ğŸ¤</div>	hiragana
hiragana-pi	<div id="japanese-heroic-character"><span class="hiragana">ã´</span></div>	<div id="japanese-romaji-answer">pi</div><div></div>	hiragana
hiragana-fu	<div id="japanese-heroic-character"><span class="hiragana">ãµ</span></div>	<div id="japanese-romaji-answer">fu</div><div></div>	hiragana
hiragana-bu	<div id="japanese-heroic-character"><span class="hiragana">ã¶</span></div>	<div id="japanese-romaji-answer">bu</div><div></div>	hiragana
hiragana-pu	<div id="japanese-heroic-character"><span class="hiragana">ã·</span></div>	<div id="japanese-romaji-answer">pu</div><div></div>	hiragana
hiragana-he	<div id="japanese-heroic-character"><span class="hiragana">ã¸</span></div>	<div id="japanese-romaji-answer">he</div><div></div>	hiragana
hiragana-be	<div id="japanese-heroic-character"><span class="hiragana">ã¹</span></div>	<div id="japanese-romaji-answer">be</div><div>ãŸã¹ã‚‹<br>ã¹ã‚“ãã‚ˆã†ã™ã‚‹</div>	hiragana
hiragana-pe	<div id="japanese-heroic-character"><span class="hiragana">ãº</span></div>	<div id="japanese-romaji-answer">pe</div><div></div>	hiragana
hiragana-ho	<div id="japanese-heroic-character"><span class="hiragana">ã»</span></div>	<div id="japanese-romaji-answer">ho</div><div>ã«ã»ã‚“ ğŸ‡¯ğŸ‡µ<br>ã«ã»ã‚“ã”</div>	hiragana
hiragana-bo	<div id="japanese-heroic-character"><span class="hiragana">ã¼</span></div>	<div id="japanese-romaji-answer">bo</div><div></div>	hiragana
hiragana-po	<div id="japanese-heroic-character"><span class="hiragana">ã½</span></div>	<div id="japanese-romaji-answer">po</div><div></div>	hiragana
hiragana-ma	<div id="japanese-heroic-character"><span class="hiragana">ã¾</span></div>	<div id="japanese-romaji-answer">ma</div><div>ãŠã¯ã‚ˆã†ã”ã–ã„ã¾ã™<br>ã¾ã›ã‚“<br>ã¾ã™<br>ã‚ãã¾</div>	hiragana
hiragana-mi	<div id="japanese-heroic-character"><span class="hiragana">ã¿</span></div>	<div id="japanese-romaji-answer">mi</div><div>ã¿ã‚‹<br>ã¿ãš ğŸ’§</div>	hiragana
hiragana-mu	<div id="japanese-heroic-character"><span class="hiragana">ã‚€</span></div>	<div id="japanese-romaji-answer">mu</div><div>ã‚ˆã‚€<br>ã®ã‚€<br>ã‚€ã— ğŸ›<br>ã‘ã‚€ã—</div>	hiragana
hiragana-me	<div id="japanese-heroic-character"><span class="hiragana">ã‚</span></div>	<div id="japanese-romaji-answer">me</div><div></div>	hiragana
hiragana-mo	<div id="japanese-heroic-character"><span class="hiragana">ã‚‚</span></div>	<div id="japanese-romaji-answer">mo</div><div></div>	hiragana
hiragana-ya	<div id="japanese-heroic-character"><span class="hiragana">ã‚„</span></div>	<div id="japanese-romaji-answer">ya</div><div>ã¦ã‚Šã‚„ã</div>	hiragana
hiragana-yu	<div id="japanese-heroic-character"><span class="hiragana">ã‚†</span></div>	<div id="japanese-romaji-answer">yu</div><div></div>	hiragana
hiragana-yo	<div id="japanese-heroic-character"><span class="hiragana">ã‚ˆ</span></div>	<div id="japanese-romaji-answer">yo</div><div>ã•ã‚ˆã†ãªã‚‰<br>ãŠã¯ã‚ˆã†ã”ã–ã„ã¾ã™<br>ãŠã¯ã‚ˆã†<br>ã‚ˆã‚€<br>ã¹ã‚“ãã‚ˆã†ã™ã‚‹<br>ã‚ˆã‚“ 4âƒ£</div>	hiragana
hiragana-ra	<div id="japanese-heroic-character"><span class="hiragana">ã‚‰</span></div>	<div id="japanese-romaji-answer">ra</div><div>ã•ã‚ˆã†ãªã‚‰<br>ã‹ã‚‰ã¦</div>	hiragana
hiragana-ri	<div id="japanese-heroic-character"><span class="hiragana">ã‚Š</span></div>	<div id="japanese-romaji-answer">ri</div><div>ã¦ã‚Šã‚„ã</div>	hiragana
hiragana-ru	<div id="japanese-heroic-character"><span class="hiragana">ã‚‹</span></div>	<div id="japanese-romaji-answer">ru</div><div>ã‚‹<br>ã‹ãˆã‚‹<br>ã¿ã‚‹<br>ã­ã‚‹<br>ãŸã¹ã‚‹<br>ãŠãã‚‹<br>ã¹ã‚“ãã‚ˆã†ã™ã‚‹<br>ã™ã‚‹<br>ãã‚‹<br>ã•ã‚‹ ğŸ’<br>ã²ã‚‹ã”ã¯ã‚“</div>	hiragana
hiragana-re	<div id="japanese-heroic-character"><span class="hiragana">ã‚Œ</span></div>	<div id="japanese-romaji-answer">re</div><div></div>	hiragana
hiragana-ro	<div id="japanese-heroic-character"><span class="hiragana">ã‚</span></div>	<div id="japanese-romaji-answer">ro</div><div>ã‚ã 6âƒ£<br>ã—ã‚</div>	hiragana
hiragana-wa	<div id="japanese-heroic-character"><span class="hiragana">ã‚</span></div>	<div id="japanese-romaji-answer">wa</div><div></div>	hiragana
hiragana-wi	<div id="japanese-heroic-character"><span class="hiragana">ã‚</span></div>	<div id="japanese-romaji-answer">wi</div><div></div>	hiragana
hiragana-we	<div id="japanese-heroic-character"><span class="hiragana">ã‚‘</span></div>	<div id="japanese-romaji-answer">we</div><div></div>	hiragana
hiragana-wo	<div id="japanese-heroic-character"><span class="hiragana">ã‚’</span></div>	<div id="japanese-romaji-answer">wo</div><div>ã‚’</div>	hiragana
hiragana-n	<div id="japanese-heroic-character"><span class="hiragana">ã‚“</span></div>	<div id="japanese-romaji-answer">n</div><div>ã«ã»ã‚“ ğŸ‡¯ğŸ‡µ<br>ã‹ã‚“ã“ã ğŸ‡°ğŸ‡·<br>ã“ã‚“ã°ã‚“ã¯<br>ã“ã‚“ã«ã¡ã¯<br>ã¾ã›ã‚“<br>ã¹ã‚“ãã‚ˆã†ã™ã‚‹<br>ã‚ˆã‚“ 4âƒ£<br>ã•ã‚“ 3âƒ£<br>ã«ã»ã‚“ã”<br>ã²ã‚‹ã”ã¯ã‚“<br>ã°ã‚“ã”ã¯ã‚“<br>ã‚ã•ã”ã¯ã‚“<br>ã”ã¯ã‚“ ğŸš<br>ãã‚“</div>	hiragana
katakana-a	<div id="japanese-heroic-character"><span class="katakana">ã‚¢</span></div>	<div id="japanese-romaji-answer">a</div><div>ã‚¢ãƒ¼ã‚¹ ğŸŒ<br>ã‚¤ã‚¿ãƒªã‚¢ ğŸ‡®ğŸ‡¹<br>ã‚¢ãƒ¡ãƒªã‚« ğŸ‡ºğŸ‡¸<br>ã‚¢ãƒ³ã‚µãƒ¼<br>ã‚¢ã‚¤ãƒ‰ãƒ«<br>ã‚¢ã‚¤ãƒ†ãƒ <br>ã‚¢ãƒ‹ãƒ¡<br>ã‚¢ã‚¤ã‚¹ã‚¯ãƒªãƒ¼ãƒ  ğŸ¦<br>ã‚¢ã‚¤ã‚¹ â„ï¸<br>ã‚¢ã‚¤ã‚¹ã‚¯ãƒ©ã‚¤ãƒãƒ¼ â„ï¸</div>	katakana
katakana-i	<div id="japanese-heroic-character"><span class="katakana">ã‚¤</span></div>	<div id="japanese-romaji-answer">i</div><div>ãƒ•ã‚¡ã‚¤ãƒŠãƒ«ãƒ•ã‚¡ãƒ³ã‚¿ã‚¸ãƒ¼<br>ã‚¤ã‚®ãƒªã‚¹ ğŸ‡¬ğŸ‡§<br>ã‚¹ãƒšã‚¤ãƒ³ ğŸ‡ªğŸ‡¸<br>ã‚¤ã‚¿ãƒªã‚¢ ğŸ‡®ğŸ‡¹<br>ãƒªã‚ªãƒ‡ã‚¸ãƒ£ãƒã‚¤ãƒ­ ğŸ‡§ğŸ‡·<br>ãƒã‚¯ã‚¿ã‚¤ ğŸ‘”<br>ã‚¢ã‚¤ãƒ‰ãƒ«<br>ã‚¢ã‚¤ãƒ†ãƒ <br>ãƒã‚¤ã‚¯<br>ã‚µãƒ³ãƒ‰ã‚¤ãƒƒãƒ ğŸ¥ª<br>ãƒ•ãƒ©ã‚¤ãƒ‰ãƒãƒ†ãƒˆ ğŸŸ<br>ã‚¢ã‚¤ã‚¹ã‚¯ãƒªãƒ¼ãƒ  ğŸ¦<br>ã‚¢ã‚¤ã‚¹ â„ï¸<br>ã‚¤ãƒ¼ã‚¹ã‚¿ãƒ¼<br>ã‚¢ã‚¤ã‚¹ã‚¯ãƒ©ã‚¤ãƒãƒ¼ â„ï¸<br>ãƒ«ã‚¤ãƒ¼ã‚¸</div>	katakana
katakana-u	<div id="japanese-heroic-character"><span class="katakana">ã‚¦</span></div>	<div id="japanese-romaji-answer">u</div><div>ãƒãƒ­ã‚¦ã‚£ãƒ³ ğŸƒ<br>ãƒ”ã‚«ãƒãƒ¥ã‚¦ âš¡ï¸</div>	katakana
katakana-e	<div id="japanese-heroic-character"><span class="katakana">ã‚¨</span></div>	<div id="japanese-romaji-answer">e</div><div>ã‚¨ã‚¹ã‚«ãƒ¬ãƒ¼ã‚¿ãƒ¼</div>	katakana
katakana-o	<div id="japanese-heroic-character"><span class="katakana">ã‚ª</span></div>	<div id="japanese-romaji-answer">o</div><div>ã‚¹ãƒ¼ãƒ‘ãƒ¼ãƒãƒªã‚ªãƒ–ãƒ©ã‚¶ãƒ¼ã‚º<br>ãƒªã‚ªãƒ‡ã‚¸ãƒ£ãƒã‚¤ãƒ­ ğŸ‡§ğŸ‡·<br>ã‚«ãƒ©ã‚ªã‚±<br>ãƒ¯ãƒªã‚ª<br>ãƒ‰ã‚¯ã‚¿ãƒ¼ãƒãƒªã‚ª ğŸ‘¨â€âš•ï¸<br>ãƒãƒªã‚ª</div>	katakana
katakana-ka	<div id="japanese-heroic-character"><span class="katakana">ã‚«</span></div>	<div id="japanese-romaji-answer">ka</div><div>ã‚«ãƒŠãƒ€ ğŸ‡¨ğŸ‡¦<br>ã‚¢ãƒ¡ãƒªã‚« ğŸ‡ºğŸ‡¸<br>ã‚¨ã‚¹ã‚«ãƒ¬ãƒ¼ã‚¿ãƒ¼<br>ã‚«ãƒ¡ãƒ© ğŸ“¸<br>ã‚«ãƒ©ã‚ªã‚±<br>ã‚«ãƒ¬ãƒ¼<br>ãƒ”ã‚«ãƒãƒ¥ã‚¦ âš¡ï¸<br>ã‚«ãƒ¼ãƒ“ã‚£<br>ã‚«ãƒ¡ãƒƒã‚¯<br>ã‚«ã‚«ã‚·</div>	katakana
katakana-ga	<div id="japanese-heroic-character"><span class="katakana">ã‚¬</span></div>	<div id="japanese-romaji-answer">ga</div><div>ã‚¯ãƒ­ãƒãƒ»ãƒˆãƒªã‚¬ãƒ¼<br>ãƒãƒ³ãƒãƒ¼ã‚¬ãƒ¼ ğŸ”</div>	katakana
katakana-ki	<div id="japanese-heroic-character"><span class="katakana">ã‚­</span></div>	<div id="japanese-romaji-answer">ki</div><div>ã‚±ãƒ¼ã‚­ ğŸ°<br>ã‚­ãƒ£ãƒ—ãƒ†ãƒ³ãƒ»ãƒ•ã‚¡ãƒ«ã‚³ãƒ³ ğŸ<br>ãƒ‰ãƒ³ã‚­ãƒ¼ã‚³ãƒ³ã‚°</div>	katakana
katakana-gi	<div id="japanese-heroic-character"><span class="katakana">ã‚®</span></div>	<div id="japanese-romaji-answer">gi</div><div>ã‚¤ã‚®ãƒªã‚¹ ğŸ‡¬ğŸ‡§<br>ã‚µãƒ³ã‚¯ã‚¹ã‚®ãƒ“ãƒ³ã‚° ğŸ¦ƒ</div>	katakana
katakana-ku	<div id="japanese-heroic-character"><span class="katakana">ã‚¯</span></div>	<div id="japanese-romaji-answer">ku</div><div>ã‚¯ãƒ­ãƒãƒ»ãƒˆãƒªã‚¬ãƒ¼<br>ãƒã‚¯ã‚¿ã‚¤ ğŸ‘”<br>ãƒã‚¤ã‚¯<br>ã‚¿ã‚¯ã‚·ãƒ¼ ğŸš•<br>ã‚¢ã‚¤ã‚¹ã‚¯ãƒªãƒ¼ãƒ  ğŸ¦<br>ã‚¯ãƒªãƒ¼ãƒ <br>ã‚µãƒ³ã‚¯ã‚¹ã‚®ãƒ“ãƒ³ã‚° ğŸ¦ƒ<br>ã‚¯ãƒªã‚¹ãƒã‚¹ ğŸ„<br>ãƒ€ãƒƒã‚¯ãƒãƒ³ãƒˆ ğŸ¦†<br>ãƒ­ãƒƒã‚¯ãƒãƒ³<br>ã‚½ãƒ‹ãƒƒã‚¯<br>ãƒ‰ã‚¯ã‚¿ãƒ¼ãƒãƒªã‚ª ğŸ‘¨â€âš•ï¸<br>ã‚¢ã‚¤ã‚¹ã‚¯ãƒ©ã‚¤ãƒãƒ¼ â„ï¸<br>ãƒ•ã‚©ãƒƒã‚¯ã‚¹ ğŸ¦Š<br>ãƒªãƒ³ã‚¯<br>ã‚¯ãƒƒãƒ‘<br>ã‚«ãƒ¡ãƒƒã‚¯<br>ã‚µã‚¯ãƒ© ğŸŒ¸<br>ãƒãƒ¼ã‚¯</div>	katakana
katakana-gu	<div id="japanese-heroic-character"><span class="katakana">ã‚°</span></div>	<div id="japanese-romaji-answer">gu</div><div>ã‚°ãƒ©ã‚¹<br>ã‚µãƒ³ã‚¯ã‚¹ã‚®ãƒ“ãƒ³ã‚° ğŸ¦ƒ<br>ãƒ‰ãƒ³ã‚­ãƒ¼ã‚³ãƒ³ã‚°</div>	katakana
katakana-ke	<div id="japanese-heroic-character"><span class="katakana">ã‚±</span></div>	<div id="japanese-romaji-answer">ke</div><div>ã‚¸ãƒ£ã‚±ãƒƒãƒˆ<br>ã‚«ãƒ©ã‚ªã‚±<br>ã‚±ãƒ¼ã‚­ ğŸ°<br>ã‚µã‚¹ã‚±</div>	katakana
katakana-ge	<div id="japanese-heroic-character"><span class="katakana">ã‚²</span></div>	<div id="japanese-romaji-answer">ge</div><div></div>	katakana
katakana-ko	<div id="japanese-heroic-character"><span class="katakana">ã‚³</span></div>	<div id="japanese-romaji-answer">ko</div><div>ã‚³ãƒ³ãƒ“ãƒ‹<br>ãƒãƒ§ã‚³ãƒ¬ãƒ¼ãƒˆ ğŸ«<br>ã‚³ãƒ¼ãƒ’ãƒ¼ â˜•ï¸<br>ã‚­ãƒ£ãƒ—ãƒ†ãƒ³ãƒ»ãƒ•ã‚¡ãƒ«ã‚³ãƒ³ ğŸ<br>ãƒ‰ãƒ³ã‚­ãƒ¼ã‚³ãƒ³ã‚°</div>	katakana
katakana-go	<div id="japanese-heroic-character"><span class="katakana">ã‚´</span></div>	<div id="japanese-romaji-answer">go</div><div></div>	katakana
katakana-sa	<div id="japanese-heroic-character"><span class="katakana">ã‚µ</span></div>	<div id="japanese-romaji-answer">sa</div><div>ã‚¢ãƒ³ã‚µãƒ¼<br>ã‚µãƒ©ãƒªãƒ¼ãƒãƒ³<br>ã‚µãƒ³ãƒ‰ã‚¤ãƒƒãƒ ğŸ¥ª<br>ã‚µãƒ³ã‚¯ã‚¹ã‚®ãƒ“ãƒ³ã‚° ğŸ¦ƒ<br>ã‚µãƒ ã‚¹<br>ã‚µã‚¯ãƒ© ğŸŒ¸<br>ã‚µã‚¹ã‚±</div>	katakana
katakana-za	<div id="japanese-heroic-character"><span class="katakana">ã‚¶</span></div>	<div id="japanese-romaji-answer">za</div><div>ã‚¹ãƒ¼ãƒ‘ãƒ¼ãƒãƒªã‚ªãƒ–ãƒ©ã‚¶ãƒ¼ã‚º<br>ãƒ”ã‚¶ ğŸ•</div>	katakana
katakana-shi	<div id="japanese-heroic-character"><span class="katakana">ã‚·</span></div>	<div id="japanese-romaji-answer">shi</div><div>ãƒŸãƒƒã‚·ãƒ§ãƒ³<br>ã‚¿ã‚¯ã‚·ãƒ¼ ğŸš•<br>ãƒ¨ãƒƒã‚·ãƒ¼ ğŸ¦–<br>ã‚«ã‚«ã‚·</div>	katakana
katakana-zi	<div id="japanese-heroic-character"><span class="katakana">ã‚¸</span></div>	<div id="japanese-romaji-answer">ji</div><div>ãƒ•ã‚¡ã‚¤ãƒŠãƒ«ãƒ•ã‚¡ãƒ³ã‚¿ã‚¸ãƒ¼<br>ãƒªã‚ªãƒ‡ã‚¸ãƒ£ãƒã‚¤ãƒ­ ğŸ‡§ğŸ‡·<br>ãƒ–ãƒ©ã‚¸ãƒ« ğŸ‡§ğŸ‡·<br>ã‚¸ãƒ£ã‚±ãƒƒãƒˆ<br>ãƒ«ã‚¤ãƒ¼ã‚¸<br>ã‚¸ãƒ§ãƒ³</div>	katakana
katakana-su	<div id="japanese-heroic-character"><span class="katakana">ã‚¹</span></div>	<div id="japanese-romaji-answer">su</div><div>ã‚¹ãƒ¼ãƒ‘ãƒ¼ãƒãƒªã‚ªãƒ–ãƒ©ã‚¶ãƒ¼ã‚º<br>ã‚¤ã‚®ãƒªã‚¹ ğŸ‡¬ğŸ‡§<br>ã‚¢ãƒ¼ã‚¹ ğŸŒ<br>ãƒ•ãƒ©ãƒ³ã‚¹ ğŸ‡«ğŸ‡·<br>ã‚¹ãƒšã‚¤ãƒ³ ğŸ‡ªğŸ‡¸<br>ã‚°ãƒ©ã‚¹<br>ã‚¨ã‚¹ã‚«ãƒ¬ãƒ¼ã‚¿ãƒ¼<br>ãƒ†ãƒ‹ã‚¹ ğŸ¾<br>ã‚¢ã‚¤ã‚¹ã‚¯ãƒªãƒ¼ãƒ  ğŸ¦<br>ã‚¢ã‚¤ã‚¹ â„ï¸<br>ã‚µãƒ³ã‚¯ã‚¹ã‚®ãƒ“ãƒ³ã‚° ğŸ¦ƒ<br>ã‚¤ãƒ¼ã‚¹ã‚¿ãƒ¼<br>ãƒãƒ¼ã‚¹ãƒ‡ãƒ¼<br>ã‚¯ãƒªã‚¹ãƒã‚¹ ğŸ„<br>ã‚¢ã‚¤ã‚¹ã‚¯ãƒ©ã‚¤ãƒãƒ¼ â„ï¸<br>ãƒã‚¹<br>ãƒ•ã‚©ãƒƒã‚¯ã‚¹ ğŸ¦Š<br>ã‚µãƒ ã‚¹<br>ã‚µã‚¹ã‚±</div>	katakana
katakana-zu	<div id="japanese-heroic-character"><span class="katakana">ã‚º</span></div>	<div id="japanese-romaji-answer">zu</div><div>ã‚¹ãƒ¼ãƒ‘ãƒ¼ãƒãƒªã‚ªãƒ–ãƒ©ã‚¶ãƒ¼ã‚º<br>ã‚ºãƒœãƒ³ ğŸ‘–<br>ãƒãƒ¼ã‚º ğŸ§€<br>ãƒ‡ã‚£ã‚ºãƒ‹ãƒ¼</div>	katakana
katakana-se	<div id="japanese-heroic-character"><span class="katakana">ã‚»</span></div>	<div id="japanese-romaji-answer">se</div><div></div>	katakana
katakana-ze	<div id="japanese-heroic-character"><span class="katakana">ã‚¼</span></div>	<div id="japanese-romaji-answer">ze</div><div>ã‚¼ãƒ­ 0ï¸âƒ£<br>ã‚¼ãƒ«ãƒ€</div>	katakana
katakana-so	<div id="japanese-heroic-character"><span class="katakana">ã‚½</span></div>	<div id="japanese-romaji-answer">so</div><div>ã‚½ãƒ•ã‚¡<br>ã‚½ãƒ‹ãƒƒã‚¯</div>	katakana
katakana-zo	<div id="japanese-heroic-character"><span class="katakana">ã‚¾</span></div>	<div id="japanese-romaji-answer">zo</div><div></div>	katakana
katakana-ta	<div id="japanese-heroic-character"><span class="katakana">ã‚¿</span></div>	<div id="japanese-romaji-answer">ta</div><div>ãƒ•ã‚¡ã‚¤ãƒŠãƒ«ãƒ•ã‚¡ãƒ³ã‚¿ã‚¸ãƒ¼<br>ã‚¤ã‚¿ãƒªã‚¢ ğŸ‡®ğŸ‡¹<br>ãƒã‚¯ã‚¿ã‚¤ ğŸ‘”<br>ã‚¨ã‚¹ã‚«ãƒ¬ãƒ¼ã‚¿ãƒ¼<br>ã‚¿ã‚¯ã‚·ãƒ¼ ğŸš•<br>ã‚¤ãƒ¼ã‚¹ã‚¿ãƒ¼<br>ãƒ‰ã‚¯ã‚¿ãƒ¼ãƒãƒªã‚ª ğŸ‘¨â€âš•ï¸</div>	katakana
katakana-da	<div id="japanese-heroic-character"><span class="katakana">ãƒ€</span></div>	<div id="japanese-romaji-answer">da</div><div>ã‚«ãƒŠãƒ€ ğŸ‡¨ğŸ‡¦<br>ãƒ€ãƒƒã‚¯ãƒãƒ³ãƒˆ ğŸ¦†<br>ã‚¼ãƒ«ãƒ€</div>	katakana
katakana-chi	<div id="japanese-heroic-character"><span class="katakana">ãƒ</span></div>	<div id="japanese-romaji-answer">chi</div><div>ã‚µãƒ³ãƒ‰ã‚¤ãƒƒãƒ ğŸ¥ª<br>ãƒãƒ§ã‚³ãƒ¬ãƒ¼ãƒˆ ğŸ«<br>ãƒãƒ¼ã‚º ğŸ§€<br>ãƒ”ã‚«ãƒãƒ¥ã‚¦ âš¡ï¸<br>ãƒ”ãƒ¼ãƒ ğŸ‘</div>	katakana
katakana-di	<div id="japanese-heroic-character"><span class="katakana">ãƒ‚</span></div>	<div id="japanese-romaji-answer">ji</div><div></div>	katakana
katakana-tsu	<div id="japanese-heroic-character"><span class="katakana">ãƒ„</span></div>	<div id="japanese-romaji-answer">tsu</div><div></div>	katakana
katakana-du	<div id="japanese-heroic-character"><span class="katakana">ãƒ…</span></div>	<div id="japanese-romaji-answer">zu</div><div></div>	katakana
katakana-te	<div id="japanese-heroic-character"><span class="katakana">ãƒ†</span></div>	<div id="japanese-romaji-answer">te</div><div>ãƒ›ãƒ†ãƒ« ğŸ¨<br>ã‚¢ã‚¤ãƒ†ãƒ <br>ãƒ†ãƒ¬ãƒ“<br>ãƒ†ãƒ‹ã‚¹ ğŸ¾<br>ãƒ•ãƒ©ã‚¤ãƒ‰ãƒãƒ†ãƒˆ ğŸŸ<br>ã‚­ãƒ£ãƒ—ãƒ†ãƒ³ãƒ»ãƒ•ã‚¡ãƒ«ã‚³ãƒ³ ğŸ</div>	katakana
katakana-de	<div id="japanese-heroic-character"><span class="katakana">ãƒ‡</span></div>	<div id="japanese-romaji-answer">de</div><div>ãƒªã‚ªãƒ‡ã‚¸ãƒ£ãƒã‚¤ãƒ­ ğŸ‡§ğŸ‡·<br>ãƒãƒ¼ã‚¹ãƒ‡ãƒ¼<br>ãƒ‡ã‚£ã‚ºãƒ‹ãƒ¼</div>	katakana
katakana-to	<div id="japanese-heroic-character"><span class="katakana">ãƒˆ</span></div>	<div id="japanese-romaji-answer">to</div><div>ã‚¯ãƒ­ãƒãƒ»ãƒˆãƒªã‚¬ãƒ¼<br>ã‚¸ãƒ£ã‚±ãƒƒãƒˆ<br>ãƒ•ãƒ©ã‚¤ãƒ‰ãƒãƒ†ãƒˆ ğŸŸ<br>ãƒãƒ§ã‚³ãƒ¬ãƒ¼ãƒˆ ğŸ«<br>ãƒ€ãƒƒã‚¯ãƒãƒ³ãƒˆ ğŸ¦†<br>ãƒ”ãƒƒãƒˆ<br>ãƒŠãƒ«ãƒˆ ğŸ¥</div>	katakana
katakana-do	<div id="japanese-heroic-character"><span class="katakana">ãƒ‰</span></div>	<div id="japanese-romaji-answer">do</div><div>ã‚¢ã‚¤ãƒ‰ãƒ«<br>ã‚µãƒ³ãƒ‰ã‚¤ãƒƒãƒ ğŸ¥ª<br>ãƒ•ãƒ©ã‚¤ãƒ‰ãƒãƒ†ãƒˆ ğŸŸ<br>ãƒ‰ã‚¯ã‚¿ãƒ¼ãƒãƒªã‚ª ğŸ‘¨â€âš•ï¸<br>ãƒ‰ãƒ³ã‚­ãƒ¼ã‚³ãƒ³ã‚°</div>	katakana
katakana-na	<div id="japanese-heroic-character"><span class="katakana">ãƒŠ</span></div>	<div id="japanese-romaji-answer">na</div><div>ãƒ•ã‚¡ã‚¤ãƒŠãƒ«ãƒ•ã‚¡ãƒ³ã‚¿ã‚¸ãƒ¼<br>ã‚«ãƒŠãƒ€ ğŸ‡¨ğŸ‡¦<br>ãƒŠãƒ«ãƒˆ ğŸ¥</div>	katakana
katakana-ni	<div id="japanese-heroic-character"><span class="katakana">ãƒ‹</span></div>	<div id="japanese-romaji-answer">ni</div><div>ã‚³ãƒ³ãƒ“ãƒ‹<br>ã‚¢ãƒ‹ãƒ¡<br>ãƒ†ãƒ‹ã‚¹ ğŸ¾<br>ã‚½ãƒ‹ãƒƒã‚¯<br>ãƒ‡ã‚£ã‚ºãƒ‹ãƒ¼</div>	katakana
katakana-nu	<div id="japanese-heroic-character"><span class="katakana">ãƒŒ</span></div>	<div id="japanese-romaji-answer">nu</div><div></div>	katakana
katakana-ne	<div id="japanese-heroic-character"><span class="katakana">ãƒ</span></div>	<div id="japanese-romaji-answer">ne</div><div>ãƒªã‚ªãƒ‡ã‚¸ãƒ£ãƒã‚¤ãƒ­ ğŸ‡§ğŸ‡·<br>ãƒã‚¯ã‚¿ã‚¤ ğŸ‘”<br>ãƒã‚¹</div>	katakana
katakana-no	<div id="japanese-heroic-character"><span class="katakana">ãƒ</span></div>	<div id="japanese-romaji-answer">no</div><div>ã‚¯ãƒ­ãƒãƒ»ãƒˆãƒªã‚¬ãƒ¼</div>	katakana
katakana-ha	<div id="japanese-heroic-character"><span class="katakana">ãƒ</span></div>	<div id="japanese-romaji-answer">ha</div><div>ãƒãƒ³ãƒãƒ¼ã‚¬ãƒ¼ ğŸ”<br>ãƒãƒ­ã‚¦ã‚£ãƒ³ ğŸƒ<br>ãƒ€ãƒƒã‚¯ãƒãƒ³ãƒˆ ğŸ¦†</div>	katakana
katakana-ba	<div id="japanese-heroic-character"><span class="katakana">ãƒ</span></div>	<div id="japanese-romaji-answer">ba</div><div>ãƒã‚¤ã‚¯<br>ãƒãƒ¬ãƒ¼ãƒœãƒ¼ãƒ« ğŸ<br>ãƒãƒ³ãƒãƒ¼ã‚¬ãƒ¼ ğŸ”<br>ãƒãƒ¼ã‚¹ãƒ‡ãƒ¼</div>	katakana
katakana-pa	<div id="japanese-heroic-character"><span class="katakana">ãƒ‘</span></div>	<div id="japanese-romaji-answer">pa</div><div>ã‚¹ãƒ¼ãƒ‘ãƒ¼ãƒãƒªã‚ªãƒ–ãƒ©ã‚¶ãƒ¼ã‚º<br>ãƒ¨ãƒ¼ãƒ­ãƒƒãƒ‘ ğŸ‡ªğŸ‡º<br>ã‚¯ãƒƒãƒ‘</div>	katakana
katakana-hi	<div id="japanese-heroic-character"><span class="katakana">ãƒ’</span></div>	<div id="japanese-romaji-answer">hi</div><div>ã‚³ãƒ¼ãƒ’ãƒ¼ â˜•ï¸</div>	katakana
katakana-bi	<div id="japanese-heroic-character"><span class="katakana">ãƒ“</span></div>	<div id="japanese-romaji-answer">bi</div><div>ã‚³ãƒ³ãƒ“ãƒ‹<br>ãƒ†ãƒ¬ãƒ“<br>ã‚µãƒ³ã‚¯ã‚¹ã‚®ãƒ“ãƒ³ã‚° ğŸ¦ƒ<br>ãƒ“ãƒ¼ãƒ« ğŸº<br>ã‚«ãƒ¼ãƒ“ã‚£</div>	katakana
katakana-pi	<div id="japanese-heroic-character"><span class="katakana">ãƒ”</span></div>	<div id="japanese-romaji-answer">pi</div><div>ãƒ”ã‚¶ ğŸ•<br>ãƒ”ãƒƒãƒˆ<br>ãƒ”ã‚«ãƒãƒ¥ã‚¦ âš¡ï¸<br>ãƒ”ãƒ¼ãƒ ğŸ‘</div>	katakana
katakana-fu	<div id="japanese-heroic-character"><span class="katakana">ãƒ•</span></div>	<div id="japanese-romaji-answer">fu</div><div>ãƒ•ã‚¡ã‚¤ãƒŠãƒ«ãƒ•ã‚¡ãƒ³ã‚¿ã‚¸ãƒ¼<br>ãƒ•ãƒ©ãƒ³ã‚¹ ğŸ‡«ğŸ‡·<br>ã‚½ãƒ•ã‚¡<br>ãƒ•ãƒ©ã‚¤ãƒ‰ãƒãƒ†ãƒˆ ğŸŸ<br>ã‚­ãƒ£ãƒ—ãƒ†ãƒ³ãƒ»ãƒ•ã‚¡ãƒ«ã‚³ãƒ³ ğŸ<br>ãƒ•ã‚©ãƒƒã‚¯ã‚¹ ğŸ¦Š</div>	katakana
katakana-bu	<div id="japanese-heroic-character"><span class="katakana">ãƒ–</span></div>	<div id="japanese-romaji-answer">bu</div><div>ã‚¹ãƒ¼ãƒ‘ãƒ¼ãƒãƒªã‚ªãƒ–ãƒ©ã‚¶ãƒ¼ã‚º<br>ãƒ–ãƒ©ã‚¸ãƒ« ğŸ‡§ğŸ‡·</div>	katakana
katakana-pu	<div id="japanese-heroic-character"><span class="katakana">ãƒ—</span></div>	<div id="japanese-romaji-answer">pu</div><div>ã‚­ãƒ£ãƒ—ãƒ†ãƒ³ãƒ»ãƒ•ã‚¡ãƒ«ã‚³ãƒ³ ğŸ</div>	katakana
katakana-he	<div id="japanese-heroic-character"><span class="katakana">ãƒ˜</span></div>	<div id="japanese-romaji-answer">he</div><div></div>	katakana
katakana-be	<div id="japanese-heroic-character"><span class="katakana">ãƒ™</span></div>	<div id="japanese-romaji-answer">be</div><div></div>	katakana
katakana-pe	<div id="japanese-heroic-character"><span class="katakana">ãƒš</span></div>	<div id="japanese-romaji-answer">pe</div><div>ã‚¹ãƒšã‚¤ãƒ³ ğŸ‡ªğŸ‡¸</div>	katakana
katakana-ho	<div id="japanese-heroic-character"><span class="katakana">ãƒ›</span></div>	<div id="japanese-romaji-answer">ho</div><div>ãƒ›ãƒ†ãƒ« ğŸ¨</div>	katakana
katakana-bo	<div id="japanese-heroic-character"><span class="katakana">ãƒœ</span></div>	<div id="japanese-romaji-answer">bo</div><div>ã‚ºãƒœãƒ³ ğŸ‘–<br>ãƒãƒ¬ãƒ¼ãƒœãƒ¼ãƒ« ğŸ</div>	katakana
katakana-po	<div id="japanese-heroic-character"><span class="katakana">ãƒ</span></div>	<div id="japanese-romaji-answer">po</div><div>ãƒ•ãƒ©ã‚¤ãƒ‰ãƒãƒ†ãƒˆ ğŸŸ</div>	katakana
katakana-ma	<div id="japanese-heroic-character"><span class="katakana">ãƒ</span></div>	<div id="japanese-romaji-answer">ma</div><div>ã‚¹ãƒ¼ãƒ‘ãƒ¼ãƒãƒªã‚ªãƒ–ãƒ©ã‚¶ãƒ¼ã‚º<br>ã‚µãƒ©ãƒªãƒ¼ãƒãƒ³<br>ã‚¯ãƒªã‚¹ãƒã‚¹ ğŸ„<br>ãƒ­ãƒƒã‚¯ãƒãƒ³<br>ãƒ‰ã‚¯ã‚¿ãƒ¼ãƒãƒªã‚ª ğŸ‘¨â€âš•ï¸<br>ã‚¢ã‚¤ã‚¹ã‚¯ãƒ©ã‚¤ãƒãƒ¼ â„ï¸<br>ãƒãƒªã‚ª<br>ãƒãƒ¼ã‚¯</div>	katakana
katakana-mi	<div id="japanese-heroic-character"><span class="katakana">ãƒŸ</span></div>	<div id="japanese-romaji-answer">mi</div><div>ãƒŸãƒƒã‚·ãƒ§ãƒ³</div>	katakana
katakana-mu	<div id="japanese-heroic-character"><span class="katakana">ãƒ </span></div>	<div id="japanese-romaji-answer">mu</div><div>ã‚¢ã‚¤ãƒ†ãƒ <br>ã‚¢ã‚¤ã‚¹ã‚¯ãƒªãƒ¼ãƒ  ğŸ¦<br>ã‚¯ãƒªãƒ¼ãƒ <br>ã‚µãƒ ã‚¹</div>	katakana
katakana-me	<div id="japanese-heroic-character"><span class="katakana">ãƒ¡</span></div>	<div id="japanese-romaji-answer">me</div><div>ã‚¢ãƒ¡ãƒªã‚« ğŸ‡ºğŸ‡¸<br>ã‚¢ãƒ‹ãƒ¡<br>ã‚«ãƒ¡ãƒ© ğŸ“¸<br>ã‚«ãƒ¡ãƒƒã‚¯</div>	katakana
katakana-mo	<div id="japanese-heroic-character"><span class="katakana">ãƒ¢</span></div>	<div id="japanese-romaji-answer">mo</div><div></div>	katakana
katakana-ya	<div id="japanese-heroic-character"><span class="katakana">ãƒ¤</span></div>	<div id="japanese-romaji-answer">ya</div><div></div>	katakana
katakana-yu	<div id="japanese-heroic-character"><span class="katakana">ãƒ¦</span></div>	<div id="japanese-romaji-answer">yu</div><div></div>	katakana
katakana-yo	<div id="japanese-heroic-character"><span class="katakana">ãƒ¨</span></div>	<div id="japanese-romaji-answer">yo</div><div>ãƒ¨ãƒ¼ãƒ­ãƒƒãƒ‘ ğŸ‡ªğŸ‡º<br>ãƒ¨ãƒƒã‚·ãƒ¼ ğŸ¦–</div>	katakana
katakana-ra	<div id="japanese-heroic-character"><span class="katakana">ãƒ©</span></div>	<div id="japanese-romaji-answer">ra</div><div>ã‚¹ãƒ¼ãƒ‘ãƒ¼ãƒãƒªã‚ªãƒ–ãƒ©ã‚¶ãƒ¼ã‚º<br>ãƒ•ãƒ©ãƒ³ã‚¹ ğŸ‡«ğŸ‡·<br>ãƒ–ãƒ©ã‚¸ãƒ« ğŸ‡§ğŸ‡·<br>ã‚°ãƒ©ã‚¹<br>ã‚µãƒ©ãƒªãƒ¼ãƒãƒ³<br>ã‚«ãƒ¡ãƒ© ğŸ“¸<br>ã‚«ãƒ©ã‚ªã‚±<br>ãƒ•ãƒ©ã‚¤ãƒ‰ãƒãƒ†ãƒˆ ğŸŸ<br>ã‚¢ã‚¤ã‚¹ã‚¯ãƒ©ã‚¤ãƒãƒ¼ â„ï¸<br>ã‚µã‚¯ãƒ© ğŸŒ¸</div>	katakana
katakana-ri	<div id="japanese-heroic-character"><span class="katakana">ãƒª</span></div>	<div id="japanese-romaji-answer">ri</div><div>ã‚¯ãƒ­ãƒãƒ»ãƒˆãƒªã‚¬ãƒ¼<br>ã‚¹ãƒ¼ãƒ‘ãƒ¼ãƒãƒªã‚ªãƒ–ãƒ©ã‚¶ãƒ¼ã‚º<br>ã‚¤ã‚®ãƒªã‚¹ ğŸ‡¬ğŸ‡§<br>ã‚¤ã‚¿ãƒªã‚¢ ğŸ‡®ğŸ‡¹<br>ãƒªã‚ªãƒ‡ã‚¸ãƒ£ãƒã‚¤ãƒ­ ğŸ‡§ğŸ‡·<br>ã‚¢ãƒ¡ãƒªã‚« ğŸ‡ºğŸ‡¸<br>ã‚µãƒ©ãƒªãƒ¼ãƒãƒ³<br>ã‚¢ã‚¤ã‚¹ã‚¯ãƒªãƒ¼ãƒ  ğŸ¦<br>ã‚¯ãƒªãƒ¼ãƒ <br>ã‚¯ãƒªã‚¹ãƒã‚¹ ğŸ„<br>ãƒ¯ãƒªã‚ª<br>ãƒ‰ã‚¯ã‚¿ãƒ¼ãƒãƒªã‚ª ğŸ‘¨â€âš•ï¸<br>ãƒªãƒ³ã‚¯<br>ãƒãƒªã‚ª</div>	katakana
katakana-ru	<div id="japanese-heroic-character"><span class="katakana">ãƒ«</span></div>	<div id="japanese-romaji-answer">ru</div><div>ãƒ•ã‚¡ã‚¤ãƒŠãƒ«ãƒ•ã‚¡ãƒ³ã‚¿ã‚¸ãƒ¼<br>ãƒ–ãƒ©ã‚¸ãƒ« ğŸ‡§ğŸ‡·<br>ãƒ›ãƒ†ãƒ« ğŸ¨<br>ã‚¢ã‚¤ãƒ‰ãƒ«<br>ãƒãƒ¬ãƒ¼ãƒœãƒ¼ãƒ« ğŸ<br>ãƒ“ãƒ¼ãƒ« ğŸº<br>ã‚¼ãƒ«ãƒ€<br>ã‚­ãƒ£ãƒ—ãƒ†ãƒ³ãƒ»ãƒ•ã‚¡ãƒ«ã‚³ãƒ³ ğŸ<br>ãƒ«ã‚¤ãƒ¼ã‚¸<br>ãƒŠãƒ«ãƒˆ ğŸ¥</div>	katakana
katakana-re	<div id="japanese-heroic-character"><span class="katakana">ãƒ¬</span></div>	<div id="japanese-romaji-answer">re</div><div>ã‚¨ã‚¹ã‚«ãƒ¬ãƒ¼ã‚¿ãƒ¼<br>ãƒ†ãƒ¬ãƒ“<br>ãƒãƒ¬ãƒ¼ãƒœãƒ¼ãƒ« ğŸ<br>ã‚«ãƒ¬ãƒ¼<br>ãƒãƒ§ã‚³ãƒ¬ãƒ¼ãƒˆ ğŸ«</div>	katakana
katakana-ro	<div id="japanese-heroic-character"><span class="katakana">ãƒ­</span></div>	<div id="japanese-romaji-answer">ro</div><div>ã‚¯ãƒ­ãƒãƒ»ãƒˆãƒªã‚¬ãƒ¼<br>ãƒªã‚ªãƒ‡ã‚¸ãƒ£ãƒã‚¤ãƒ­ ğŸ‡§ğŸ‡·<br>ãƒ¨ãƒ¼ãƒ­ãƒƒãƒ‘ ğŸ‡ªğŸ‡º<br>ã‚¼ãƒ­ 0ï¸âƒ£<br>ãƒãƒ­ã‚¦ã‚£ãƒ³ ğŸƒ<br>ãƒ­ãƒƒã‚¯ãƒãƒ³</div>	katakana
katakana-wa	<div id="japanese-heroic-character"><span class="katakana">ãƒ¯</span></div>	<div id="japanese-romaji-answer">wa</div><div>ãƒ¯ãƒªã‚ª</div>	katakana
katakana-wi	<div id="japanese-heroic-character"><span class="katakana">ãƒ°</span></div>	<div id="japanese-romaji-answer">wi</div><div></div>	katakana
katakana-we	<div id="japanese-heroic-character"><span class="katakana">ãƒ±</span></div>	<div id="japanese-romaji-answer">we</div><div></div>	katakana
katakana-wo	<div id="japanese-heroic-character"><span class="katakana">ãƒ²</span></div>	<div id="japanese-romaji-answer">wo</div><div></div>	katakana
katakana-n	<div id="japanese-heroic-character"><span class="katakana">ãƒ³</span></div>	<div id="japanese-romaji-answer">n</div><div>ãƒ•ã‚¡ã‚¤ãƒŠãƒ«ãƒ•ã‚¡ãƒ³ã‚¿ã‚¸ãƒ¼<br>ãƒ•ãƒ©ãƒ³ã‚¹ ğŸ‡«ğŸ‡·<br>ã‚¹ãƒšã‚¤ãƒ³ ğŸ‡ªğŸ‡¸<br>ã‚³ãƒ³ãƒ“ãƒ‹<br>ã‚ºãƒœãƒ³ ğŸ‘–<br>ã‚¢ãƒ³ã‚µãƒ¼<br>ã‚µãƒ©ãƒªãƒ¼ãƒãƒ³<br>ãƒŸãƒƒã‚·ãƒ§ãƒ³<br>ã‚µãƒ³ãƒ‰ã‚¤ãƒƒãƒ ğŸ¥ª<br>ãƒãƒ³ãƒãƒ¼ã‚¬ãƒ¼ ğŸ”<br>ã‚µãƒ³ã‚¯ã‚¹ã‚®ãƒ“ãƒ³ã‚° ğŸ¦ƒ<br>ãƒãƒ­ã‚¦ã‚£ãƒ³ ğŸƒ<br>ãƒ€ãƒƒã‚¯ãƒãƒ³ãƒˆ ğŸ¦†<br>ãƒ­ãƒƒã‚¯ãƒãƒ³<br>ã‚­ãƒ£ãƒ—ãƒ†ãƒ³ãƒ»ãƒ•ã‚¡ãƒ«ã‚³ãƒ³ ğŸ<br>ãƒªãƒ³ã‚¯<br>ãƒ‰ãƒ³ã‚­ãƒ¼ã‚³ãƒ³ã‚°<br>ã‚¸ãƒ§ãƒ³</div>	katakana
hiragana-katakana-a	<div id="japanese-kana-pair"><span class="hiragana">ã‚</span> <span class="katakana">ã‚¢</span></div>	<div id="japanese-romaji-answer">a</div>	pair
hiragana-katakana-i	<div id="japanese-kana-pair"><span class="hiragana">ã„</span> <span class="katakana">ã‚¤</span></div>	<div id="japanese-romaji-answer">i</div>	pair
hiragana-katakana-u	<div id="japanese-kana-pair"><span class="hiragana">ã†</span> <span class="katakana">ã‚¦</span></div>	<div id="japanese-romaji-answer">u</div>	pair
hiragana-katakana-e	<div id="japanese-kana-pair"><span class="hiragana">ãˆ</span> <span class="katakana">ã‚¨</span></div>	<div id="japanese-romaji-answer">e</div>	pair
hiragana-katakana-o	<div id="japanese-kana-pair"><span class="hiragana">ãŠ</span> <span class="katakana">ã‚ª</span></div>	<div id="japanese-romaji-answer">o</div>	pair
hiragana-katakana-ka	<div id="japanese-kana-pair"><span class="hiragana">ã‹</span> <span class="katakana">ã‚«</span></div>	<div id="japanese-romaji-answer">ka</div>	pair
hiragana-katakana-ga	<div id="japanese-kana-pair"><span class="hiragana">ãŒ</span> <span class="katakana">ã‚¬</span></div>	<div id="japanese-romaji-answer">ga</div>	pair
hiragana-katakana-ki	<div id="japanese-kana-pair"><span class="hiragana">ã</span> <span class="katakana">ã‚­</span></div>	<div id="japanese-romaji-answer">ki</div>	pair
hiragana-katakana-gi	<div id="japanese-kana-pair"><span class="hiragana">ã</span> <span class="katakana">ã‚®</span></div>	<div id="japanese-romaji-answer">gi</div>	pair
hiragana-katakana-ku	<div id="japanese-kana-pair"><span class="hiragana">ã</span> <span class="katakana">ã‚¯</span></div>	<div id="japanese-romaji-answer">ku</div>	pair
hiragana-katakana-gu	<div id="japanese-kana-pair"><span class="hiragana">ã</span> <span class="katakana">ã‚°</span></div>	<div id="japanese-romaji-answer">gu</div>	pair
hiragana-katakana-ke	<div id="japanese-kana-pair"><span class="hiragana">ã‘</span> <span class="katakana">ã‚±</span></div>	<div id="japanese-romaji-answer">ke</div>	pair
hiragana-katakana-ge	<div id="japanese-kana-pair"><span class="hiragana">ã’</span> <span class="katakana">ã‚²</span></div>	<div id="japanese-romaji-answer">ge</div>	pair
hiragana-katakana-ko	<div id="japanese-kana-pair"><span class="hiragana">ã“</span> <span class="katakana">ã‚³</span></div>	<div id="japanese-romaji-answer">ko</div>	pair
hiragana-katakana-go	<div id="japanese-kana-pair"><span class="hiragana">ã”</span> <span class="katakana">ã‚´</span></div>	<div id="japanese-romaji-answer">go</div>	pair
hiragana-katakana-sa	<div id="japanese-kana-pair"><span class="hiragana">ã•</span> <span class="katakana">ã‚µ</span></div>	<div id="japanese-romaji-answer">sa</div>	pair
hiragana-katakana-za	<div id="japanese-kana-pair"><span class="hiragana">ã–</span> <span class="katakana">ã‚¶</span></div>	<div id="japanese-romaji-answer">za</div>	pair
hiragana-katakana-shi	<div id="japanese-kana-pair"><span class="hiragana">ã—</span> <span class="katakana">ã‚·</span></div>	<div id="japanese-romaji-answer">shi</div>	pair
hiragana-katakana-zi	<div id="japanese-kana-pair"><span class="hiragana">ã˜</span> <span class="katakana">ã‚¸</span></div>	<div id="japanese-romaji-answer">ji</div>	pair
hiragana-katakana-su	<div id="japanese-kana-pair"><span class="hiragana">ã™</span> <span class="katakana">ã‚¹</span></div>	<div id="japanese-romaji-answer">su</div>	pair
hiragana-katakana-zu	<div id="japanese-kana-pair"><span class="hiragana">ãš</span> <span class="katakana">ã‚º</span></div>	<div id="japanese-romaji-answer">zu</div>	pair
hiragana-katakana-se	<div id="japanese-kana-pair"><span class="hiragana">ã›</span> <span class="katakana">ã‚»</span></div>	<div id="japanese-romaji-answer">se</div>	pair
hiragana-katakana-ze	<div id="japanese-kana-pair"><span class="hiragana">ãœ</span> <span class="katakana">ã‚¼</span></div>	<div id="japanese-romaji-answer">ze</div>	pair
hiragana-katakana-so	<div id="japanese-kana-pair"><span class="hiragana">ã</span> <span class="katakana">ã‚½</span></div>	<div id="japanese-romaji-answer">so</div>	pair
hiragana-katakana-zo	<div id="japanese-kana-pair"><span class="hiragana">ã</span> <span class="katakana">ã‚¾</span></div>	<div id="japanese-romaji-answer">zo</div>	pair
hiragana-katakana-ta	<div id="japanese-kana-pair"><span class="hiragana">ãŸ</span> <span class="katakana">ã‚¿</span></div>	<div id="japanese-romaji-answer">ta</div>	pair
hiragana-katakana-da	<div id="japanese-kana-pair"><span class="hiragana">ã </span> <span class="katakana">ãƒ€</span></div>	<div id="japanese-romaji-answer">da</div>	pair
hiragana-katakana-chi	<div id="japanese-kana-pair"><span class="hiragana">ã¡</span> <span class="katakana">ãƒ</span></div>	<div id="japanese-romaji-answer">chi</div>	pair
hiragana-katakana-di	<div id="japanese-kana-pair"><span class="hiragana">ã¢</span> <span class="katakana">ãƒ‚</span></div>	<div id="japanese-romaji-answer">ji</div>	pair
hiragana-katakana-tsu	<div id="japanese-kana-pair"><span class="hiragana">ã¤</span> <span class="katakana">ãƒ„</span></div>	<div id="japanese-romaji-answer">tsu</div>	pair
hiragana-katakana-du	<div id="japanese-kana-pair"><span class="hiragana">ã¥</span> <span class="katakana">ãƒ…</span></div>	<div id="japanese-romaji-answer">zu</div>	pair
hiragana-katakana-te	<div id="japanese-kana-pair"><span class="hiragana">ã¦</span> <span class="katakana">ãƒ†</span></div>	<div id="japanese-romaji-answer">te</div>	pair
hiragana-katakana-de	<div id="japanese-kana-pair"><span class="hiragana">ã§</span> <span class="katakana">ãƒ‡</span></div>	<div id="japanese-romaji-answer">de</div>	pair
hiragana-katakana-to	<div id="japanese-kana-pair"><span class="hiragana">ã¨</span> <span class="katakana">ãƒˆ</span></div>	<div id="japanese-romaji-answer">to</div>	pair
hiragana-katakana-do	<div id="japanese-kana-pair"><span class="hiragana">ã©</span> <span class="katakana">ãƒ‰</span></div>	<div id="japanese-romaji-answer">do</div>	pair
hiragana-katakana-na	<div id="japanese-kana-pair"><span class="hiragana">ãª</span> <span class="katakana">ãƒŠ</span></div>	<div id="japanese-romaji-answer">na</div>	pair
hiragana-katakana-ni	<div id="japanese-kana-pair"><span class="hiragana">ã«</span> <span class="katakana">ãƒ‹</span></div>	<div id="japanese-romaji-answer">ni</div>	pair
hiragana-katakana-nu	<div id="japanese-kana-pair"><span class="hiragana">ã¬</span> <span class="katakana">ãƒŒ</span></div>	<div id="japanese-romaji-answer">nu</div>	pair
hiragana-katakana-ne	<div id="japanese-kana-pair"><span class="hiragana">ã­</span> <span class="katakana">ãƒ</span></div>	<div id="japanese-romaji-answer">ne</div>	pair
hiragana-katakana-no	<div id="japanese-kana-pair"><span class="hiragana">ã®</span> <span class="katakana">ãƒ</span></div>	<div id="japanese-romaji-answer">no</div>	pair
hiragana-katakana-ha	<div id="japanese-kana-pair"><span class="hiragana">ã¯</span> <span class="katakana">ãƒ</span></div>	<div id="japanese-romaji-answer">ha</div>	pair
hiragana-katakana-ba	<div id="japanese-kana-pair"><span class="hiragana">ã°</span> <span class="katakana">ãƒ</span></div>	<div id="japanese-romaji-answer">ba</div>	pair
hiragana-katakana-pa	<div id="japanese-kana-pair"><span class="hiragana">ã±</span> <span class="katakana">ãƒ‘</span></div>	<div id="japanese-romaji-answer">pa</div>	pair
hiragana-katakana-hi	<div id="japanese-kana-pair"><span class="hiragana">ã²</span> <span class="katakana">ãƒ’</span></div>	<div id="japanese-romaji-answer">hi</div>	pair
hiragana-katakana-bi	<div id="japanese-kana-pair"><span class="hiragana">ã³</span> <span class="katakana">ãƒ“</span></div>	<div id="japanese-romaji-answer">bi</div>	pair
hiragana-katakana-pi	<div id="japanese-kana-pair"><span class="hiragana">ã´</span> <span class="katakana">ãƒ”</span></div>	<div id="japanese-romaji-answer">pi</div>	pair
hiragana-katakana-fu	<div id="japanese-kana-pair"><span class="hiragana">ãµ</span> <span class="katakana">ãƒ•</span></div>	<div id="japanese-romaji-answer">fu</div>	pair
hiragana-katakana-bu	<div id="japanese-kana-pair"><span class="hiragana">ã¶</span> <span class="katakana">ãƒ–</span></div>	<div id="japanese-romaji-answer">bu</div>	pair
hiragana-katakana-pu	<div id="japanese-kana-pair"><span class="hiragana">ã·</span> <span class="katakana">ãƒ—</span></div>	<div id="japanese-romaji-answer">pu</div>	pair
hiragana-katakana-he	<div id="japanese-kana-pair"><span class="hiragana">ã¸</span> <span class="katakana">ãƒ˜</span></div>	<div id="japanese-romaji-answer">he</div>	pair
hiragana-katakana-be	<div id="japanese-kana-pair"><span class="hiragana">ã¹</span> <span class="katakana">ãƒ™</span></div>	<div id="japanese-romaji-answer">be</div>	pair
hiragana-katakana-pe	<div id="japanese-kana-pair"><span class="hiragana">ãº</span> <span class="katakana">ãƒš</span></div>	<div id="japanese-romaji-answer">pe</div>	pair
hiragana-katakana-ho	<div id="japanese-kana-pair"><span class="hiragana">ã»</span> <span class="katakana">ãƒ›</span></div>	<div id="japanese-romaji-answer">ho</div>	pair
hiragana-katakana-bo	<div id="japanese-kana-pair"><span class="hiragana">ã¼</span> <span class="katakana">ãƒœ</span></div>	<div id="japanese-romaji-answer">bo</div>	pair
hiragana-katakana-po	<div id="japanese-kana-pair"><span class="hiragana">ã½</span> <span class="katakana">ãƒ</span></div>	<div id="japanese-romaji-answer">po</div>	pair
hiragana-katakana-ma	<div id="japanese-kana-pair"><span class="hiragana">ã¾</span> <span class="katakana">ãƒ</span></div>	<div id="japanese-romaji-answer">ma</div>	pair
hiragana-katakana-mi	<div id="japanese-kana-pair"><span class="hiragana">ã¿</span> <span class="katakana">ãƒŸ</span></div>	<div id="japanese-romaji-answer">mi</div>	pair
hiragana-katakana-mu	<div id="japanese-kana-pair"><span class="hiragana">ã‚€</span> <span class="katakana">ãƒ </span></div>	<div id="japanese-romaji-answer">mu</div>	pair
hiragana-katakana-me	<div id="japanese-kana-pair"><span class="hiragana">ã‚</span> <span class="katakana">ãƒ¡</span></div>	<div id="japanese-romaji-answer">me</div>	pair
hiragana-katakana-mo	<div id="japanese-kana-pair"><span class="hiragana">ã‚‚</span> <span class="katakana">ãƒ¢</span></div>	<div id="japanese-romaji-answer">mo</div>	pair
hiragana-katakana-ya	<div id="japanese-kana-pair"><span class="hiragana">ã‚„</span> <span class="katakana">ãƒ¤</span></div>	<div id="japanese-romaji-answer">ya</div>	pair
hiragana-katakana-yu	<div id="japanese-kana-pair"><span class="hiragana">ã‚†</span> <span class="katakana">ãƒ¦</span></div>	<div id="japanese-romaji-answer">yu</div>	pair
hiragana-katakana-yo	<div id="japanese-kana-pair"><span class="hiragana">ã‚ˆ</span> <span class="katakana">ãƒ¨</span></div>	<div id="japanese-romaji-answer">yo</div>	pair
hiragana-katakana-ra	<div id="japanese-kana-pair"><span class="hiragana">ã‚‰</span> <span class="katakana">ãƒ©</span></div>	<div id="japanese-romaji-answer">ra</div>	pair
hiragana-katakana-ri	<div id="japanese-kana-pair"><span class="hiragana">ã‚Š</span> <span class="katakana">ãƒª</span></div>	<div id="japanese-romaji-answer">ri</div>	pair
hiragana-katakana-ru	<div id="japanese-kana-pair"><span class="hiragana">ã‚‹</span> <span class="katakana">ãƒ«</span></div>	<div id="japanese-romaji-answer">ru</div>	pair
hiragana-katakana-re	<div id="japanese-kana-pair"><span class="hiragana">ã‚Œ</span> <span class="katakana">ãƒ¬</span></div>	<div id="japanese-romaji-answer">re</div>	pair
hiragana-katakana-ro	<div id="japanese-kana-pair"><span class="hiragana">ã‚</span> <span class="katakana">ãƒ­</span></div>	<div id="japanese-romaji-answer">ro</div>	pair
hiragana-katakana-wa	<div id="japanese-kana-pair"><span class="hiragana">ã‚</span> <span class="katakana">ãƒ¯</span></div>	<div id="japanese-romaji-answer">wa</div>	pair
hiragana-katakana-wi	<div id="japanese-kana-pair"><span class="hiragana">ã‚</span> <span class="katakana">ãƒ°</span></div>	<div id="japanese-romaji-answer">wi</div>	pair
hiragana-katakana-we	<div id="japanese-kana-pair"><span class="hiragana">ã‚‘</span> <span class="katakana">ãƒ±</span></div>	<div id="japanese-romaji-answer">we</div>	pair
hiragana-katakana-wo	<div id="japanese-kana-pair"><span class="hiragana">ã‚’</span> <span class="katakana">ãƒ²</span></div>	<div id="japanese-romaji-answer">wo</div>	pair
hiragana-katakana-n	<div id="japanese-kana-pair"><span class="hiragana">ã‚“</span> <span class="katakana">ãƒ³</span></div>	<div id="japanese-romaji-answer">n</div>	pair
